............
............
.........p..
............
...#...#....
...../......
..../d/.....
...../......
...#...#....
............
............
............
1001
3
7
8