............
............
..-....*....
.....#......
.....#......
...##p##.d..
.....#......
../..#.d....
............
.....d......
............
............
3
4
5
7
2
10
12
3