............
.p.....#..#.
............
...w.ww.w...
....-..-..#.
...w.ww.w...
...w.ww.w...
.#..-..dw...
...w.wwww...
............
.#..#.......
............
13
10
100
6
15
35