............
............
..p.....*...
.....#......
....#.#.....
...#.#.#.d..
....#.#.....
.....#......
..*.....-...
.....d......
............
............
10
1
2
8
6
7
4
1
20