............
............
............
.....p......
............
....d..d....
...wwwwww...
...w.s..w...
....####....
............
............
............
4
9
16
25