............
.....w......
...#.w......
.....w......
...#.w......
.p...*...d..
.....*......
...#.w......
.....w......
...#.w......
.....w......
............
3
7
4
5