............
.wwwwwwwwww.
.wp.......w.
.w.d#..#d.w.
.w.#.ww.#.w.
.w...ww...w.
.w...ww...w.
.w.#.ww.#.w.
.w.d#..#d.w.
.w........w.
.wwwwwwwwww.
............
5
7
13
11
19
2
3
17