............
............
..p.........
............
....w#*#w...
....#.#.#...
....*#d#d...
....#.#.#...
....w#d#w...
............
............
............
4
10
100
1
15
16
2
12
10
6
20
40