............
............
..p.........
....####....
...#w-/w#...
...#-dds#...
...#*dd/#...
...#w2*w#...
....####....
............
............
............
20
10
4
7
6
8
5
2
15
25
17
9
1
0
13
4