............
............
............
.....p......
............
............
...-.#.*....
............
...#.*.#....
............
.....d......
............
3
5
6