............
............
..p.........
............
....w.d.w...
.....#.#....
....d.w.d...
.....#.#....
....w.d.w...
............
............
............
101
59
43
191