............
.........#..
..p.#.#..#..
.........#..
............
wwwwwddwwwww
wwwwwddwwwww
............
.........#..
..-.*./..#..
.........#..
............
8
9
21
14
15
10
4
6