............
.p........*.
............
...wwwwww...
....####....
......#.....
....#.#.....
....###.....
...wwwwww...
............
.-........d.
............
4
7
11
3
13
6
2
3
4
5