............
............
............
.....#......
......wwww..
.p.#.#2-dw..
......wwww..
.....#......
............
............
............
............
14
10
6
5