............
............
..p.........
.........*..
............
.....###....
.....#.#....
.....###....
.........d..
...*....d...
............
............
7
8
7
4
4
9
8
8