............
............
..p......d..
............
....####..s.
....#..#....
....#..#....
....####../.
............
..d......d..
....-..*....
............
1
44
32
28
50
16
25
20
77
84
64
99