p...........
............
..#......#..
............
....2..s....
............
............
....s..d....
............
..#......#..
............
............
20
9
21
15