p...........
.www.ww.www.
.www.ww.www.
..#.#..d....
.www.ww.www.
.www.ww.www.
..#.d..#.#..
.www.ww.www.
.www.ww.www.
..#.#..d....
.www.ww.www.
............
9
10
3
7
2
7
16