............
............
..p.........
............
...d#####d..
......#.....
......#.....
......#.....
......#.....
......d.....
............
............
10
8
13
4
6
11
7
5
9