............
............
............
...p..../...
............
............
......d##...
......#.#...
...-..##d...
............
............
............
8
6
20
4
16
12